#...##
#....#
##.###
##.###
##.###
#....#
\robot 4 0
\robot 3 0
\robot 2 0