...#######
.........#
####..####
#.....#..#
#..####..#
#........#
#...#.##.#
\robot 1 0
\robot 2 0
\robot 3 0
