..###################
....#...............#
#.#####.#.#.###.#.#.#
#.......#.#...#.#.#..
###################..
\robot 0 4
\robot 1 4
\robot 0 3